30 67 67 31 30 67 67 67 67 67 67 67 67 67 67 31
30 4 4 31 30 4 4 4 4 4 4 4 4 4 4 31
30 4 4 31 30 4 4 4 4 4 4 4 4 4 4 31
30 4 4 31 30 4 4 4 69 69 4 4 4 4 4 31
30 4 4 31 30 4 4 4 31 30 4 4 4 4 4 67
30 4 4 31 30 4 4 4 31 30 4 4 4 4 4 68
30 4 4 16 17 4 4 4 31 30 4 4 4 4 4 69
30 4 4 4 4 4 4 4 31 30 4 4 4 4 4 31
30 4 4 4 4 4 4 4 31 30 4 4 4 4 4 31
30 4 4 4 4 4 4 4 31 30 4 4 4 4 4 31
30 69 69 69 69 69 69 69 31 30 69 69 69 69 69 31
28 9 9 9 9 9 9 9 29 28 9 9 9 9 9 29